13
12
9,8,7,7,7,6,6,5,1,1,R,R
8,8,7,6,5,L,L,3,1,1,R,R
7,7,7,6,5,L,3,3,1,1,R,R
6,6,6,6,5,4,3,3,5,6,R,R
5,4,5,5,L,L,3,6,7,7,R,R
3,3,3,4,L,L,4,6,7,7,1,R
1,2,2,4,2,2,5,6,7,7,1,R
1,2,2,6,6,6,6,6,7,7,1,1
1,1,1,1,1,1,3,2,3,7,1,1
1,1,1,1,2,1,3,1,2,7,2,1
R,R,R,R,1,1,4,1,1,6,L,L
R,R,R,R,R,1,1,1,5,5,L,L
R,R,R,R,R,R,R,R,1,5,6,L